60,0,0,0,0,0,0,0,0,0,
0,0,0,0,0,0,0,0,0,0,
0,0,0,0,0,0,0,0,0,0,

0,0,0,0,0,0,0,0,0,0,
0,0,0,0,0,0,0,0,0,0,
0,0,

160,160,115,55,55,55,55,55,
55,55,55,55,55,55,55,55,
55,55,0,0,0,0,0,0,0,0,0,0,0,0,0,0,0,0,0,

0,0,55,55,55,55,55,55,55,55,0,0,0,
40,40,40,40,0,0,0,0,0,0,
0,0,0,0,40,40,40,40,0,0,

0,0,0,0,0,0,0,0,0,
55,55,55,55,55,85,85,85,85,
155,200,0,0,0,0,0,0,0,0,0,
0,0,0,0,0,0,0,0,0,0,


0,0,0,0,0,0,0,0,0,0,
0,0,0,0,0,0,0,0,0,0,

0,0,0,0,
0,0,0,0,0,0,0,0,0,0,0,0,0,0,0,40,40,40,40,0,0,
0,0,0,0,0,0,
0,30,30,30,30,0,0,

0,0,0,0,0,0,0,0,0,0,0,0,

0,0,0,0,0,0,0,0,0,




80,80,80,80,80,80,20,20,20,20,20,0,0,0,
10,10,10,10,10,10,10,10,10,10,0,0,0,0,0,0,0,0,0,0,0,


0,0,0,0,140,140,140,
140,140,140,140,140,0,0,0,0,0,0,0,0,

0,0,0,0,0,0,0,0,
0,0,0,0,50,50,10,10,
10,0,0,0,0,0,0,0,0,

0,0,0,0,0,0,0,0,0,0,0,0,0,0,0,0,0,
0,0,0,0,0,0,0,0,0,0,0,0,60,0,
0,20,20,20,20,20,0

0,0,0,0,60,60,

