40,40,40,40,0,0,0,0,80,80,
0,0,0,0,0,0,0,0,0,0,
0,0,0,0,0,0,0,0,0,0,

0,0,0,0,0,0,0,0,0,0,
0,0,0,0,0,0,0,0,0,0,
0,0,0,0,0,0,0,0,0,0,

40,40,40,40,80,80,80,80,0,0,
0,0,0,0,0,0,0,0,
104,104,104,104,104,104,104,104,104,104,0,0,


0,0,0,0,0,0,0,0,0,0,
0,0,0,0,0,0,0,0,0,0,
0,0,0,0,0,0,0,0,0,0,

0,0,0,0,0,0,0,0,0,0,
0,0,0,0,0,0,0,0,0,0,
0,0,0,0,0,0,0,0,0,0,
0,0,0,0,0,0,0,0,0,0,


0,0,0,0,0,0,0,0,0,0,
0,0,0,0,0,0,0,0,0,0,


80,80,80,0,0,0,
0,0,0,0,0,0,0,0,0,0,
0,80,80,80,0,0,0,0,0,0,0,0,0,0,0,0,0,

0,0,0,0,0,0,0,0,0,0,0,0,
0,0,0,0,0,
0,0,0,0,0,0,0,0,0,0,

0,0,0,0,

0,0,0,0,
104,104,112,112,112,112,74,74,74,74,40,40,40,40,
0,0,0,0,0,0,0,0,0,80,80,80,


0,0,0,0,0,0,0,80,80,80,
0,0,0,0,0,0,0,0,0,0,

0,0,0,0,0,0,0,0,0,0,
0,0,0,0,0,0,0,0,0,0,
0,0,0,0,0,0,

0,0,0,0,0,0,0,0,0,0,0,0,0,0,
0,0,0,0,80,80,80,104,104,104,
0,0,0,0,0,0,0,0,0,0,0

0,0,0,0,0,0,

