0,0,0,0,0,0,0,0,0,0,
0,0,0,0,0,0,0,0,0,0,
0,0,0,0,0,0,0,0,0,0,

0,0,0,0,0,0,0,0,0,0,
0,0,0,0,0,0,0,0,0,0,
0,0,0,0,0,0,0,0,0,0,

0,0,6,20,34,48,62,78,94,108,116,130,
130,130,130,92,92,92,64,64,64,50,
50,50,0,0,0,0,0,0,


0,0,0,0,10,10,20,20,20,0,
0,0,0,0,0,0,0,0,0,0,
0,0,0,0,0,0,0,0,0,0,

0,0,0,0,0,0,0,0,0,0,
0,0,0,0,0,0,0,0,0,0,
0,0,0,0,0,0,0,0,0,0,
0,0,0,0,0,0,0,0,0,0,


62,62,62,20,20,-6,-12,-18,-24,-30,
-36,-42,-48,-54,-60,-66,-72,-78,-84,-90,


-96,-102,-102,-102,-102,-96,-90,-84,-78,-72,
-66,-60,-54,-48,-42,-36,-30,-24,-18,-12,
-6,62,62,62,62,20,20,20,0,0,0,0,0,

0,0,0,0,0,0,0,0,0,0,0,0,
0,0,0,0,0,
0,0,0,0,0,0,0,0,0,0,

0,0,0,0,

0,0,0,0,0,0,0,62,62,62,
62,62,62,62,34,34,34,0,0,0,
0,0,0,0,0,0,0,0,0,0,


0,0,0,0,0,0,0,0,0,0,
0,0,0,0,0,0,0,0,0,0,

0,0,0,0,0,0,0,0,0,0,
0,0,0,0,0,0,0,0,0,0,
0,0,0,0,62,62,62,62,62,62,

62,62,62,34,34,20,20,0,0,0,
0,0,0,94,94,0,0,0,0,0,
20,20,20,20,20,0,0,20,20,0,0

0,0,0,0,0,0,

