40,40,40,0,0,0,0,0,0,0,
0,0,0,0,0,0,0,0,0,0,
0,0,0,0,0,0,0,0,0,0,

0,0,0,0,0,0,0,0,0,0,
0,0,0,0,0,0,0,0,0,0,
0,0,0,0,0,0,0,0,0,0,

6,20,34,48,62,78,94,108,116,130,
130,130,130,92,92,64,64,50,
50,0,0,0,0,0,0,0,0,0,0,0,


0,0,0,0,0,0,0,0,0,0,
0,0,0,0,0,0,0,0,0,0,
0,0,0,0,0,0,0,0,0,0,

0,0,0,0,0,0,0,0,0,0,
0,0,0,0,0,0,0,0,0,0,
0,0,0,0,0,0,0,0,0,0,
0,0,0,0,0,0,0,0,0,0,


92,92,92,92,92,40,40,-18,-24,-30,
-36,-42,-48,-54,-60,-66,-72,-78,-84,-90,


-96,-96,-90,-84,-78,-72,
-66,-60,-54,-48,-42,-36,-30,-24,-18,-12,
-6,92,92,92,92,40,40,40,0,0,0,0,0,0,0,0,0,

0,0,0,0,0,0,0,0,0,0,0,0,
0,0,0,0,0,
0,0,0,0,0,0,0,0,0,0,

0,0,0,0,

0,97,97,97,
97,97,97,97,97,97,59,59,59,59,0,0,0,0,
0,0,0,0,0,0,0,0,0,0,0,0,


0,0,0,0,0,0,0,0,0,0,
0,0,0,0,0,0,0,0,0,0,

0,0,0,0,0,0,0,0,0,0,
0,0,0,0,0,0,0,0,0,0,
112,112,112,112,112,112,

112,112,112,74,74,40,40,0,0,0,0,0,0,0,
0,0,0,104,104,104,104,0,0,0,
40,40,40,40,40,40,40,40,40,40,40

40,0,0,0,0,0,

